---A-----------------------A------------------------------------------------------------------------
-----------------------------------------------------------------------------------------------M----
----------------------------------------------------------------------------------------------------
----------------------------------------------------------------------------------------------------
----------------------------------------------------------------------------------------------------
----------------------------------------------------------------------------A-----------------------
---------------------------A------------------------------------------------------------------------
----------------------------------------------------------------------------------------------------
---------------------------------XXXXXXXXXXXXXXXXXXXXXXXXXXXXXXXXXX---------------------------------
---------------------------------X                                X---------------------------------
---------------------------------X                                XA--------------------------------
---------------------------------X                                X---------------------------------
-M-------------------------------X                                X---------------------------------
---------------------------------X                                X---------------------------------
---------------------------------X                                X---------------------------------
--------------------------------AX                                X-------A-------------------------
----------------------A----------X                                X---------------------------------
---------------------------------X                                X---------------------------------
---------------------------------X                                X---------------------------------
---------------------------------XXXXXXXXXXXXXXXXXXXXXXXXXXXXXXXXXX---------------------------------
----------------------------------------------------------------------------------------------------
----------------------------------------------------------------------------------------------------
---------------------------A-------------------------------------------------------------A----------
----------------------------------------------------------------------------------------------------
-------------------------------------------------------------------------A--------------------------
----------------------------------------------------------------------------------------------------
----------------------------------------------------------------------------------------------------
--------------------------------------------------------------------------------------------------M-