----------------------------------------------------------------------------------------------------
--A-------------------------------------------------------------------------------------------------
-----------------------------------------------------------M----------------------------------------
---------------A-----------------------------------------------------------------------A------------
----------------------------------------------------------------------------------------------------
----------------------------------------------------------------------------------------------------
----------------------------------A-----------------------------------------------------------------
----------------------------------------------------------------------------------------------------
---------------------------------XXXXXXXXXXXXXXXXXXXXXXXXXXXXXXXXXX---------------------------------
---------------------------------X                                X------------------M--------------
---------------------------------X                                X---------------------------------
------A--------------------------X                                X---------------------------------
---------------------------------X                                X---------------------------------
---------------------------------X                                X---------------------------------
---------------------------------X                                X---------------------------------
---------------------------------X                                X------------------M--------------
-------M-------------------------X                                X---------------------------------
---------------------------------X                                X---------------------------------
---------------------------------X                                X---------------------------------
---------------------------------XXXXXXXXXXXXXXXXXXXXXXXXXXXXXXXXXX---------------------------------
----------------------------------------------------------------------------------------------------
----------------------------------------------------------------------------------------------------
------------------------------------------------------M---------------------A-----------------------
----------------------------------------------------------------------------------------------------
------------A-----------------------------------------------------------------------------A---------
-------------------------------------A--------------------------------------------------------------
----------------------------------------------------------------------------------------------------
----------------------------------------------------------------------------------------------------