----------------------------------------------------------------------------------------------------
----------------------------------------------------------------------------------------------------
----------------------------------------------------------------------------------------------------
---------------A-----------------------------------A------------------------------------A-----------
----------------------------------------------------------------------------------------------------
----------------------------------------------------------------------------------------------------
----------------------------------------------------------------------------------------------------
----------------------------------------------------------------------------------------------------
---------------------------------XXXXXXXXXXXXXXXXXXXXXXXXXXXXXXXXXX-------------A-------------------
------------------------A--------X                                X---------------------------------
---------------------------------X                                X---------------------------------
--------------------------------AX                                X---------------------------------
-----------------------M--------MX                                X---------------------------------
--------------------------------AX                                X---------------------------------
---------------------------------X                                X---------------------------------
---------------------------------X                                X---------------------------------
---------------------------------X                                X---------------------------------
---------------------------------X                                X---------------------------------
---------------------------------X                                X---------------------------------
---------------------------------XXXXXXXXXXXXXXXXXXXXXXXXXXXXXXXXXX---------------------------------
----------------------------------------------------------------------------------------------------
----------------------------------------------------------------------------------------------------
----------------------------------------------------------------------------------------------------
-----------------M-------------------------------M---------------------------------M----------------
----------------------------------------------------------------------------------------------------
----------------------------------------------------------------------------------------------------
-----------------------M-------------------------------------------------------------M--------------
----------------------------------------------------------------------------------------------------